{
  "StartPosition": {
    "x": 26,
    "y": 1,
    "magnitude": 26.0192242,
    "sqrMagnitude": 677
  },
  "Enemies": [
    0,
    2,
    2,
    2,
    3,
    3,
    5,
    5,
  ],
  "Field": [
    "111111111111111111111111111111111111111111111111111",
    "111111111111111111111111111111111111111111111111111",
    "110000000000000000000000000000000000000000000000011",
    "110000000000000000000000000000000000000000000000011",
    "110000000000001111100001000100001111100000000000011",
    "110000000000000010000001000100001000000000000000011",
    "110000000000000010000001111100001110000000000000011",
    "110000000000000010000001000100001000000000000000011",
    "110000000000000010000001000100001111100000000000011",
    "110000000000000000000000000000000000000000000000011",
    "110000000000000000000000000000000000000000000000011",
    "110000000000000000000000000000000000000000000000011",
    "110000000000000000000000000000000000000000000000011",
    "110000000000011111000001000100000111100000000000011",
    "110000000000010000000001100100000100010000000000011",
    "110000000000011100000001010100000100010000000000011",
    "110000000000010000000001001100000000010000000000011",
    "110000000000011111000001000100000111100000000000011",
    "110000000000000000000000000000000000000000000000011",
    "110000000000000000000000000000000000000000000000011",
    "110000000000000000000000000000000000000000000000011",
    "110000000000000000000000000000000000000000000000011",
    "110000000000000000000000000000000000000000000000011",
    "110000000000000000000000000000000000000000000000011",
    "110000000000000000000000000000000000000000000000011",
    "110000000000000000000000000000000000000000000000011",
    "110000000000000000000000000000000000000000000000011",
    "110000000000000000000000000000000000000000000000011",
    "110000000000000000000000000000000000000000000000011",
    "111111111111111111111111111111111111111111111111111",
    "111111111111111111111111111111111111111111111111111"
  ]
}