{
  "StartPosition": {
    "x": 26,
    "y": 1,
    "magnitude": 26.0192242,
    "sqrMagnitude": 677
  },
  "Enemies": [
    0,
    0,
    1,
    1,
    2,
    3
  ],
  "Field": [
    "111111111111111111111111111111111111111111111111111",
    "111111111111111111111111111111111111111111111111111",
    "110000000000000000000000000000000000000000000000011",
    "110000000000000000000000000000000000000000000000011",
    "110000000000000000000000000000000000000000000000011",
    "110000000000000000000000000000000000000000000000011",
    "110000000000000000000000000000000000000000000000011",
    "110000000000000000000000000000000000000000000000011",
    "110000000000000000000000000000000000000000000000011",
    "110000000000000011111111111111111111100000000000011",
    "110000000000000000000000000000000000000000000000011",
    "110000000000000000000000000000000000000000000000011",
    "110000000000000000000000000000000000000000000000011",
    "110000000000000000000000000000000000000000000000011",
    "110000000000000000000000000000000000000000000000011",
    "110000000000000000000000000000000000000000000000011",
    "110000000000000000000000000000000000000000000000011",
    "110000000000000000000000000000000000000000000000011",
    "110000000000000000000000000000000000000000000000011",
    "110000000000000000000000000000000000000000000000011",
    "110000000000000011111111111111111111100000000000011",
    "110000000000000000000000000000000000000000000000011",
    "110000000000000000000000000000000000000000000000011",
    "110000000000000000000000000000000000000000000000011",
    "110000000000000000000000000000000000000000000000011",
    "110000000000000000000000000000000000000000000000011",
    "110000000000000000000000000000000000000000000000011",
    "110000000000000000000000000000000000000000000000011",
    "110000000000000000000000000000000000000000000000011",
    "111111111111111111111111111111111111111111111111111",
    "111111111111111111111111111111111111111111111111111"
  ]
}