{
  "StartPosition": {
    "x": 26,
    "y": 1,
    "magnitude": 26.0192242,
    "sqrMagnitude": 677
  },
  "Enemies": [
    0,
    0,
    1,
    1,
    2,
    2,
    3,
    3,
    3,
    5,
    5
  ],
  "Field": [
    "111111111111111111111111111111111111111111111111111",
    "111111111111111111111111111111111111111111111111111",
    "110000000000000000000000000000000000000000000000011",
    "110000000000000000000000000000000000000000000000011",
    "110000000000000000000000000000000000000000000000011",
    "110000000000000000000000000000000000000000000000011",
    "110000000000000000000000000000000000000000000000011",
    "110000000000000000000000000000000000000000000000011",
    "110000000000000000000000000000000000000000000000011",
    "110000000000000000000000000000000000000000000000011",
    "110000000000000000000000000000000000000000000000011",
    "110000000000000000000000000000000000000000000000011",
    "110000000001000100111001000100111001000100000000011",
    "110000000000101001000101100100010000101000000000011",
    "110000000000010001000101010100010000010000000000011",
    "110000000000101001000101001100010000101000000000011",
    "110000000001000100111001000100111001000100000000011",
    "110000000000000000000000000000000000000000000000011",
    "110000000000000000000000000000000000000000000000011",
    "110000000000000000000000000000000000000000000000011",
    "110000000000000000000000000000000000000000000000011",
    "110000000000000000000000000000000000000000000000011",
    "110000000000000000000000000000000000000000000000011",
    "110000000000000000000000000000000000000000000000011",
    "110000000000000000000000000000000000000000000000011",
    "110000000000000000000000000000000000000000000000011",
    "110000000000000000000000000000000000000000000000011",
    "110000000000000000000000000000000000000000000000011",
    "110000000000000000000000000000000000000000000000011",
    "111111111111111111111111111111111111111111111111111",
    "111111111111111111111111111111111111111111111111111"
  ]
}