{
  "StartPosition": {
    "x": 26,
    "y": 1,
    "magnitude": 26.0192242,
    "sqrMagnitude": 677
  },
  "Enemies": [
    0,
    2,
    2,
    2
  ],
  "Field": [
    "111111111111111111111111111111111111111111111111111",
    "111111111111111111111111111111111111111111111111111",
    "110000000000000000000000000000000000000000000000011",
    "110000000000000000000000000000000000000000000000011",
    "110000000001111100000100010000001111100000000000011",
    "110000000000010000000100010000001000000000000000011",
    "110000000000010000000111110000001110000000000000011",
    "110000000000010000000100010000001000000000000000011",
    "110000000000010000000100010000001111100000000000011",
    "110000000000000000000000000000000000000000000000011",
    "110000000000000000000000000000000000000000000000011",
    "110000000000000000000000000000000000000000000000011",
    "110000000000000000000000000000000000000000000000011",
    "1100000000011111000001000100000011110000000000000011",
    "110000000001000000000110010000001000100000000000011",
    "110000000001110000000101010000001000100000000000011",
    "110000000001000000000100110000000000100000000000011",
    "110000000001111100000100010000001111000000000000011",
    "110000000000000000000000000000000000000000000000011",
    "110000000000000000000000000000000000000000000000011",
    "110000000000000000000000000000000000000000000000011",
    "110000000000000000000000000000000000000000000000011",
    "110000000000000000000000000000000000000000000000011",
    "110000000000000000000000000000000000000000000000011",
    "110000000000000000000000000000000000000000000000011",
    "110000000000000000000000000000000000000000000000011",
    "110000000000000000000000000000000000000000000000011",
    "110000000000000000000000000000000000000000000000011",
    "110000000000000000000000000000000000000000000000011",
    "111111111111111111111111111111111111111111111111111",
    "111111111111111111111111111111111111111111111111111"
  ]
}